   ############################
               #           #  #
#######  #  ####  #######  #  #
#     #  #     #  #  #        #
#  ####  #  #  ####  #######  #
#     #  #  #  #        #  #  #
#  ##########  #  #  #  #  #  #
#     #        #  #  #     #  #
#  #  #  #  #  #######  #  #  #
#  #     #  #     #  #  #     #
#  #  ##########  #  #######  #
#  #     #        #  #        #
#############  ####  ####  #  #
#     #        #  #  #  #  #  #
#  ####  #######  #  #  ####  #
#        #  #     #  #        #
#  ####  #  #  #  #  #  #  ####
#  #  #  #     #        #     #
####  #  #  #  ##########  ####
#           #     #
############################
