...############################
.........#........#...........#
#######..#..#######..####..#..#
#...........#.....#..#.....#..#
#######..####..##########..####
#.....#.................#.....#
#..#######..#..#..#..#..#..####
#.....#..#..#..#..#..#........#
#..####..#..#############..####
#........#.....#..#........#..#
#..#..##########..####..####..#
#..#.....#..#..#...........#..#
#..#######..#..#######..#..#..#
#..#.....#..............#.....#
#..#..#..#######..#..#######..#
#..#..#........#..#.....#.....#
#..####..#..#######..#..#..#..#
#.....#..#.....#..#..#..#..#..#
####..####..#..#..#..#..#..####
#...........#........#..#......
############################...
